--------------
-OOO.---------
-OTOOOO-------
-OOOOOOOOO----
--OOOOOOOOO---
-------OOSOO--
-------OOO----
--------------
