--------------
-OOOO---------
-OTOOOO-------
-OOOOOOOOO----
--OOOOOOOOO---
-------OOOOO--
-------OOS----
--------------

