--------------
-OOOO---------
-OTOOO.-------
-OOOOO.OOO----
--OOOO.OOOO---
-------OOOOO--
-------OOS----
--------------


