----------------------------
-OOOO-----------------------
-OTOOO.---------------------
-OOOOO.OOO------------------
--OOOO.OOOO---------.-------
-------OOOOOS-------.-----O-
-------OOO----------.-------
----------------------------
------O---------------------
-----OOO--------------------
----------------------------


